1111011111111111111111111111
1C000000000001000001000000P1
1010111111110101100100001111
1010000000010100100100000001
1111111111010110100111000001
10000E1001010100100100000001
1011111001000111100100001111
1010101000000000000000000001
1010000000011111111110000001
1011111111110000011000110101
1000000000000010000010000101
1111111111111111111111111111
