111111111111111111111111111111
1C00010000000100000100000000P1
101011111111010110010000001111
101000E00001010010010000000001
111111111101011010011100000001
10000C100101010010010000000001
101111100100011110010000001111
101010100000000000000000000001
101000000001111111111000000001
101111111111000001100011010001
1000000000000010000010000100C1
111111111111111111111111111111
